##############################
#          #     #      #    #
#   #     #        #         #
###      #   #           #   #
S ##    #   # #      #       #
# #    #   ##                #
####       #    #      #     #
#         #      #           #
###   #########   ##      #  #
#           ####             #
#   ###                 ##   #
#                   ####     E
##############################