###############
#             #
#             #
#             #
#####ES########