###############
#         #####
# ### ## ######
S #   ##      #
#####E#########