###############
S         #####
##### #########
###   #########
#####E#########