###############
#         #####
# ### #########
# #   #########
#S###E#########