###############
#         #####
# ### ## ######
# #   ##      S
#####E#########