##############################
#          #                 #
#   #     #                  #
###      #                   #
S ##    #   #                #
#      #   ##                #
####            #            #
#                #           #
#     #########   ##         #
#           ####             #
#   ###                 ##   #
#                   ####     E
##############################